436,437,438,439,440,441,442,443,444,445,436,437,438,439,440,441,442,443,444,445,436,437,438,439,440,441,442,443,444,445,436,437,438,439,440,441,442,443,444,445,436,437,438,439,440,441,442,443,444,445,436,437,438,439,440,441,442,443,444,445
465,466,467,468,469,470,471,472,473,474,465,466,467,468,469,470,471,472,473,474,465,466,467,468,469,470,471,472,473,474,465,466,467,468,469,470,471,472,473,474,465,466,467,468,469,470,471,472,473,474,465,466,467,468,469,470,471,472,473,474
494,495,496,497,498,499,500,501,502,503,494,495,496,497,498,499,500,501,502,503,494,495,496,497,498,499,500,501,502,503,494,495,496,497,498,499,500,501,502,503,494,495,496,497,498,499,500,501,502,503,494,495,496,497,498,499,500,501,502,503
523,524,525,526,527,528,529,530,531,532,523,524,525,526,527,528,529,530,531,532,523,524,525,526,527,528,529,530,531,532,523,524,525,526,527,528,529,530,531,532,523,524,525,526,527,528,529,530,531,532,523,524,525,526,527,528,529,530,531,532
494,495,496,497,498,499,500,501,502,503,494,495,496,497,498,499,500,501,502,503,494,495,496,497,498,499,500,501,502,503,494,495,496,497,498,499,500,501,502,503,494,495,496,497,498,499,500,501,502,503,494,495,496,497,498,499,500,501,502,503
523,524,525,526,527,528,529,530,531,532,523,524,525,526,527,528,529,530,531,532,523,524,525,526,527,528,529,530,531,532,523,524,525,526,527,528,529,530,531,532,523,524,525,526,527,528,529,530,531,532,523,524,525,526,527,528,529,530,531,532
552,553,554,555,556,557,558,559,560,561,552,553,554,555,556,557,558,559,560,561,552,553,554,555,556,557,558,559,560,561,552,553,554,555,556,557,558,559,560,561,552,553,554,555,556,557,558,559,560,561,552,553,554,555,556,557,558,559,560,561
581,582,583,584,585,586,587,588,589,590,581,582,583,584,585,586,587,588,589,590,581,582,583,584,585,586,587,588,589,590,581,582,583,584,585,586,587,588,589,590,581,582,583,584,585,586,587,588,589,590,581,582,583,584,585,586,587,588,589,590
610,611,612,613,614,615,616,617,618,619,610,611,612,613,614,615,616,617,618,619,610,611,612,613,614,615,616,617,618,619,610,611,612,613,614,615,616,617,618,619,610,611,612,613,614,615,616,617,618,619,610,611,612,613,614,615,616,617,618,619
494,495,496,497,498,499,500,501,502,503,494,495,496,497,498,499,500,501,502,503,494,495,496,497,498,499,500,501,502,503,494,495,496,497,498,499,500,501,502,503,494,495,496,497,498,499,500,501,502,503,494,495,496,497,498,499,500,501,502,503
523,524,525,526,527,528,529,530,531,532,523,524,525,526,527,528,529,530,531,532,523,524,525,526,527,528,529,530,531,532,523,524,525,526,527,528,529,530,531,532,523,524,525,526,527,528,529,530,531,532,523,524,525,526,527,528,529,530,531,532
